4 4
3 1 2 1 b
1 1 1 1 b
1 2 1 1 b
3 3 1 2 b
2 1 1 3 b
2 3 2 1 b
4 2 2 1 b
4 4 1 1 b
