3 3
2 2 1 1 b
1 2 2 1 b
3 2 2 1 b
1 2 1 2 b
2 3 1 1 b