4 5
3 1 1 1 h
2 2 1 2 v
3 3 1 2 v
4 3 1 1 b
1 2 1 1 v
5 3 1 1 v
1 5 1 2 v
4 5 1 2 v 
