4 4
3 1 2 1 h
1 1 1 1 b
1 2 1 1 b
2 1 1 1 b
2 3 2 1 h
3 3 1 2 v
4 1 2 1 h
4 4 1 1 b
1 2 1 1 b
1 2 1 1 b
4 1 2 1 h
