4 3
3 1 1 1 b
1 1 2 1 b
4 1 3 1 b
2 1 1 1 b
2 2 2 1 b
3 3 1 1 b
